--------   
|      |#####
|      |    #    ----------------
|      |    #    |              |
|      |    #    |              |
|      |    #####|              |
|      |         |              | 
|      |         ----------------
|      |
--------
