--------   
|......|#####
|......|    #    ----------------
|......|    #    |..............|
|......|    #    |..............|
|......|    #####|..............|
|......|         |..............| 
|......|         ----------------
|......|
--------
