--------   
|......+#####
|......|    #    ----------------
|.@....|    #    |..............|
|......|    #    |..............|
|......|    #####+..............|
|......|         |..............| 
|......|         ----------------
|......|
--------
